# Named entities
# Add two columns:
# Column 1: Classify each line as: persona (incl. dieties), place, other name or non-name (error)
# Column 2: Add the gender (M, F or PL), if this is not an error. For plural forms, gender is PL (e.g. ⲛ ⲣⲓ 'Kellia' is a place that occurs as PL) 
# For lines containing a real name but bad segmentation (e.g. ⲛϣⲉⲛⲟⲩⲧⲉ), please fix the name as well
# If a name contains multiple tokens (as in ⲛ ⲣⲓ, or ⲡ ⲁⲛⲧⲓⲭⲣⲏⲥⲧⲟⲥ please add spaces between them)
# If a name regularly appears with an article, you can leave it in (with space), e.g. the persona ⲡ ⲥⲁⲧⲁⲛⲁⲥ
# Example classification:
# ⲡ ⲥⲁⲧⲁⲛⲁⲥ	persona	M
ϣⲉⲛⲟⲩⲧⲉ	persona	M
ϣⲓⲏⲧ	place	F
ϥⲛⲏⲟⲩ	non-name
ϩⲁⲙⲱⲥ	persona	M
ϩⲉⲛϣⲗⲏⲗ	non-name
ϩⲉⲛϩⲓⲥⲁⲅⲅⲉⲗⲟⲥ	non-name
ϩⲉⲛⲥⲫⲁⲣⲓⲥⲥⲁⲓⲟⲥ	non-name
ϩⲉⲣⲙⲏⲥ	place	M
ϩⲉⲣⲙⲟⲅⲉⲛⲏⲥ	persona	M
ϩⲏⲏⲧⲉ	non-name
ϩⲏⲗⲉⲓⲁⲥ	persona	M
ϩⲏⲗⲓⲁⲥ	persona	M	# same as ϩⲏⲗⲉⲓⲁⲥ
ϩⲏⲣⲱⲇⲏⲥ	persona	M
ϩⲏⲣⲱⲇⲓⲁⲥ	persona	M
ϩⲏⲧϥ	non-name
ϩⲏⲧⲟⲩ	non-name
ϩⲏⲧⲥ	non-name
ⲁⲛⲛⲁⲥ	persona	M
ϩⲓⲉⲣⲟⲥⲟⲗⲩⲙⲁ	place	F	# same as ϩⲓⲉⲣⲟⲩⲥⲁⲗⲏⲙ
ϩⲓⲉⲣⲟⲩⲥⲁⲗⲏⲙ	place	F
ϩⲣⲁⲁⲃ	persona	F
ϩⲣⲁⲭⲏⲗ	persona	F
ϩⲣⲉⲃⲉⲕⲕⲁ	persona	F
ϩⲣⲟⲃⲟⲁⲙ	persona	M
ϩⲣⲟⲩⲫⲟⲥ	persona	M
ϩⲣⲱⲙⲏ	place	F
ϩⲩⲙⲉⲛⲁⲓⲟⲥ	persona	M	
ϩⲩⲡⲉⲣⲉⲭⲓⲟⲥ	persona	M
ϩⲱⲧⲧⲏⲩⲧⲛ	non-name
ⲁϥϯⲡⲉϥⲟⲩⲟⲓ	non-name
ⲁϥⲁⲣⲭⲓ	non-name
ⲁϥⲛϣⲟⲧ	non-name
ⲁϥⲥⲉⲡⲥ	non-name
ⲁϥⲥⲙⲛⲧⲥ	non-name
ⲁϩⲉⲛⲕⲉⲧⲉⲗⲱⲛⲏⲥ	non-name
ⲁϫⲓⲥ	non-name
ⲁⲁⲣⲱⲛ	persona	M
ⲁⲃⲉⲗ	persona	M
ⲁⲃⲓⲁⲑⲁⲣ	persona	M
ⲁⲃⲓⲁⲥ		persona	M	# same as ⲁⲃⲓⲁ
ⲁⲃⲓⲁ	persona	M	
ⲁⲃⲓⲟⲩⲇ	persona	M
ⲁⲃⲣⲁϩⲁⲙ	persona	M
ⲁⲅⲟⲩⲥⲧⲟⲥ	persona	M
ⲁⲅⲣⲓⲡⲡⲁⲥ	persona	M
ⲁⲇⲁⲙ	persona	M
ⲁⲍⲱⲣⲁⲥ	persona	M	# same as ⲁⲍⲱⲣⲁ
ⲁⲍⲱⲣⲁ	persona	M
ⲁⲓⲁ	non-name
ⲁⲓⲥⲉⲡⲥ	non-name
ⲓⲥ	persona	M
ⲁⲕⲉⲁⲅⲅⲉⲗⲟⲥ	non-name
ⲁⲕⲩⲗⲁⲥ	persona	M
ⲁⲗⲉⲝⲁⲛⲇⲣⲟⲥ	persona	M
ⲁⲙⲓⲛⲁⲇⲁⲃ	persona	M
ⲁⲙⲙⲁⲑⲏⲧⲏⲥ	non-name
ⲁⲙⲱⲛⲁ	persona	M
ⲁⲛϩⲉⲑⲛⲟⲥ	non-name
ⲁⲛⲁⲛⲓⲁⲥ	persona	M
ⲁⲛⲁⲡⲟⲥⲧⲟⲗⲟⲥ	non-name
ⲁⲛⲇⲁⲓⲙⲱⲛⲓⲟⲛ	non-name
ⲁⲛⲇⲣⲉⲁⲥ	persona	M
ⲁⲛⲉϥⲙⲁⲑⲏⲧⲏⲥ	non-name
ⲁⲛⲉⲅⲣⲁⲙⲙⲁⲧⲉⲩⲥ	non-name
ⲁⲛⲉⲥⲧⲣⲁⲧⲏⲅⲟⲥ	non-name
ⲛⲓⲕⲟⲇⲏⲙⲟⲥ	persona	M
ⲁⲛⲗⲁⲟⲥ	non-name
ⲁⲛⲛⲁ	persona	F
ⲁⲛⲧⲱⲛⲓⲟⲥ	persona	M
ⲁⲟⲩⲁ	non-name
ⲁⲡϣⲁϫⲉ	non-name
ⲁⲡϣⲟⲣⲡ	non-name
ⲁⲡϩⲉⲕⲁⲧⲟⲛⲧⲁⲣⲭⲟⲥ	non-name
ⲁⲡϩⲙϩⲁⲗ	non-name
ⲁⲡϫⲟⲉⲓⲥ	non-name
ⲁⲡⲁⲅⲅⲉⲗⲟⲥ	non-name
ⲁⲡⲁⲗⲁⲥ	non-name
ⲁⲡⲁⲣⲭⲓⲥⲩⲛⲁⲅⲱⲅⲟⲥ	non-name	
ⲁⲡⲁⲣⲭⲓⲧⲣⲓⲕⲗⲓⲛⲟⲥ	non-name
ⲁⲡⲉϥⲙⲁⲑⲏⲧⲏⲥ	non-name
ⲁⲡⲉⲇⲣⲁⲕⲱⲛ	non-name
ⲁⲡⲉⲕⲗⲏⲣⲟⲥ	non-name
ⲁⲡⲉⲥⲡⲛⲉⲩⲙⲁ	non-name
ⲁⲡⲕⲉⲟⲩⲁ	non-name
ⲁⲡⲕⲉⲧⲉⲗⲱⲛⲏⲥ	non-name
ⲁⲡⲗⲁⲟⲥ	non-name
ⲁⲡⲙⲛⲧⲥⲛⲟⲟⲩⲥ	non-name
ⲁⲡⲛⲟⲙⲟⲥ	non-name
ⲁⲡⲟⲗⲗⲱ	persona	M
ⲁⲡⲭⲓⲗⲓⲁⲣⲭⲟⲥ	non-name
ⲁⲣⲁⲙ	persona	M
ⲁⲣⲉⲧⲁ	persona	M
ⲁⲣⲓϩⲉⲛⲕⲁⲣⲡⲟⲥ	non-name
ⲁⲣⲓⲙⲁⲑⲁⲓⲟⲥ	place	M	
ⲁⲣⲓⲥⲧⲁⲣⲭⲟⲥ	persona	M
ⲁⲣⲭⲏⲗⲁⲟⲥ	persona	M
ⲁⲥϥⲓϩⲣⲁⲥ	non-name
ⲁⲥϭⲟⲥϭⲥ	non-name
ⲁⲥϯⲡⲉⲥⲟⲩⲟⲓ	non-name
ⲁⲥⲁⲫ	persona	M
ⲁⲥⲛⲇⲟⲕⲓ	non-name
ⲁⲧⲉⲥⲙⲏ	non-name
ⲁⲧⲉⲭⲁⲣⲓⲥ	non-name
ⲁⲩϩⲉⲃⲱⲱⲛ	non-name
ⲁⲩϫⲟⲕⲙⲉⲥ	non-name
ⲁⲩϯⲡⲉⲩⲟⲩⲟⲓ	non-name
ⲁⲩⲁϣⲕⲁⲕ	non-name
ⲁⲩⲁⲣⲭⲓ	non-name
ⲁⲩⲁⲣⲭⲱⲛ	non-name
ⲁⲩⲍⲏⲧⲏⲥⲓⲥ	non-name
ⲁⲩⲛⲟϭ	non-name
ⲁⲩⲡⲁⲣⲟⲝⲩⲥⲙⲟⲥ	non-name
ⲁⲩⲥⲁⲙⲁⲣⲓⲧⲏⲥ	non-name
ⲁⲫⲉⲕⲁⲧⲟⲛⲧⲁⲣⲭⲟⲥ	non-name
ⲁⲫⲏⲅⲉⲙⲱⲛ	non-name
ⲁⲫⲑⲟⲛⲓⲁ	persona	F
ⲁⲭⲉⲓⲙ	persona	M
ⲃⲁⲃⲩⲗⲱⲛ	place	F
ⲃⲁⲗⲗⲁ	persona	F
ⲃⲁⲣⲁⲃⲃⲁⲥ	persona	M
ⲃⲁⲣⲁⲭⲓⲁⲥ	persona	M
ⲃⲁⲣⲑⲟⲗⲟⲙⲁⲓⲟⲥ	persona	M
ⲃⲁⲣⲛⲁⲃⲁⲥ	persona	M
ⲃⲁⲣⲥⲁⲃⲁⲥ	persona	M
ⲃⲁⲣⲧⲓⲙⲁⲓⲟⲥ	persona	M
ⲃⲁⲥⲓⲙⲟⲥ	persona	M
ⲃⲃⲁⲧⲟⲥ	non-name
ⲃⲉⲉⲗⲍⲉⲃⲟⲩⲗ	persona	M
ⲃⲏⲇⲥⲁⲓⲇⲁ	place	F
ⲃⲏⲑⲁⲛⲓⲁ	place	F
ⲃⲏⲥⲁⲣⲓⲟⲛ	persona	M
ⲃⲟⲉⲥ	persona	M
ⲅⲁⲃⲃⲁⲑⲁ	place	F
ⲅⲁⲃⲣⲓⲏⲗ	persona	M
ⲅⲁⲓⲟⲥ	persona	M
ⲅⲁⲗⲓⲗⲁⲓⲁ	place	F
ⲅⲁⲗⲗⲓⲱⲛ	persona	M
ⲅⲁⲙⲁⲗⲓⲏⲗ	persona	M
ⲅⲉⲇⲉⲱⲛ	persona	M
ⲅⲟⲗⲅⲟⲑⲁ	place	M
ⲅⲟⲙⲟⲣⲣⲁ	place	F
ⲇⲁⲗⲙⲁⲛⲟⲩⲑⲁ	place	F
ⲇⲁⲙⲁⲥⲕⲟⲥ	place	M
ⲇⲁⲛⲓⲏⲗ	persona	M
ⲇⲁⲩⲉⲓⲇ	persona	M
ⲇⲉⲃⲃⲱⲣⲁ	persona	F
ⲇⲏⲙⲁⲥ	persona	M
ⲇⲓⲁⲃⲟⲗⲟⲥ	persona	M
ⲇⲓⲇⲩⲙⲟⲥ	persona	M
ⲇⲓⲙⲏⲧⲣⲓⲟⲥ	persona	M	# same as ⲧⲩⲙⲏⲧⲣⲓⲟⲥ
ⲇⲓⲟⲛⲏⲥⲓⲟⲥ	persona	M
ⲇⲓⲟⲥⲕⲟⲣⲟⲥ	persona	M
ⲇⲟⲣⲕⲁⲥ	persona	F	#	same as ⲧⲟⲣⲕⲁⲥ
ⲇⲟⲩⲗⲟⲥ	persona	M
ⲉϥϣⲁⲛϫⲟⲟⲥ	non-name
ⲉϥϩⲏⲗ	non-name
ⲉϥϯⲕⲁⲣⲡⲟⲥ	non-name
ⲉϥⲛⲏⲟⲩ	non-name
ⲉϥⲡⲣⲟϩⲓⲥⲧⲁ	non-name
ⲉϯⲛⲁⲥ	non-name
ⲉϯⲛⲁ	non-name
ⲉⲁⲥⲕⲟⲥ	non-name
ⲉⲁⲩⲣⲙⲉⲧⲟⲭⲟⲥ	non-name
ⲉⲍⲉⲕⲉⲓⲁⲥ	persona	M
ⲉⲓϩⲁ	non-name
ⲉⲓⲉϯⲛⲁⲛⲟⲙⲟⲥ	non-name
ⲉⲓⲉⲍⲁⲃⲉⲗ	persona	F
ⲉⲓⲛⲁⲧⲛⲧⲛ	non-name
ⲉⲓⲟⲩⲥⲧⲟⲥ	persona	M
ⲉⲓⲥⲟⲩⲁ	non-name
ⲉⲕⲉⲙⲉⲣⲉⲡϫⲟⲉⲓⲥ	non-name
ⲕⲩⲡⲣⲟⲥ	place	M
ⲉⲗⲉⲁⲍⲁⲣ	persona	M
ⲉⲗⲓⲁⲕⲓⲙ	persona	M
ⲉⲗⲓⲟⲩⲇ	persona	M
ⲉⲗⲓⲥⲁⲃⲉⲧ	persona	F
ⲉⲗⲓⲥⲥⲁⲓⲟⲥ	persona	M
ⲉⲗⲩⲙⲁⲥ	persona	M
ⲉⲙⲙⲟⲛ	non-name
ⲉⲙⲛⲕⲉⲟⲩⲁ	non-name
ⲉⲙⲡⲟⲩⲁ	non-name
ⲉⲛϣⲁϫⲟⲟⲥ	non-name
ⲉⲛϣⲁⲛϫⲟⲟⲥ	non-name
ⲉⲛⲁϣⲱⲟⲩ	non-name
ⲉⲛⲁⲁⲁⲥ	non-name
ⲉⲛⲁⲓⲁ	persona	M
ⲉⲛⲉϥⲙⲉⲅⲓⲥⲧⲁⲛⲟⲥ	non-name
ⲉⲛⲉⲛⲧⲁⲩⲥⲟⲩⲱⲛⲥ	non-name
ⲉⲛⲉⲛⲧⲁ	non-name
ⲉⲛⲛⲁⲱϩⲥ	non-name
ⲉⲛⲣⲭⲣⲓⲁ	non-name
ⲉⲛⲧⲁⲧⲁ	non-name
ⲉⲛⲧⲁ	non-name
ⲉⲛⲱⲭ	persona	M
ⲉⲡⲁⲫⲣⲁⲥ	persona	M	# same as ⲉⲡⲁⲫⲣⲁ
ⲉⲡⲉϣⲗⲏⲗ	non-name
ⲉⲡⲉⲕϣⲗⲏⲗ	non-name
ⲉⲡⲫⲁⲑⲁ	non-name
ⲉⲡⲭⲓⲗⲓⲁⲣⲭⲟⲥ	non-name
ⲉⲣϣⲁⲛⲟⲩⲁ	non-name
ⲉⲣϣⲁⲛⲡⲉⲥⲕⲗⲁⲇⲟⲥ	non-name
ⲉⲣϣⲁⲛⲡⲕⲁⲣⲡⲟⲥ	non-name
ⲉⲣⲁⲥⲧⲟⲥ	persona	M
ⲕⲩⲣⲓⲛⲟⲥ	persona	M
ⲉⲣⲉⲛⲁⲓ	non-name
ⲉⲣⲉⲡⲕⲟⲥⲙⲟⲥ	non-name
ⲉⲣⲉⲡⲗⲁⲟⲥ	non-name
ⲉⲣⲡⲛⲟⲙⲟⲥ	non-name
ⲉⲣⲧⲙⲡⲟⲩⲁ	non-name
ⲉⲥⲣⲱⲙ	persona	M
ⲉⲧⲃⲏⲧⲥ	non-name
ⲉⲧⲉϥⲛⲁⲁⲁⲥ	non-name
ⲉⲧⲉⲛⲁⲓ	non-name
ⲉⲧⲉⲣⲛⲉⲁⲅⲅⲉⲗⲟⲥ	non-name
ⲉⲧⲉⲧⲛϯⲕⲁⲣⲡⲟⲥ	non-name
ⲉⲧⲉⲧⲛⲁϫⲟⲟⲥ	non-name
ⲉⲧⲉⲧⲛⲉⲁⲁⲥ	non-name
ⲉⲧⲉⲧⲛⲣⲭⲣⲓⲁ	non-name
ⲉⲧⲙⲧⲣⲉⲛⲣϩⲙϩⲁⲗ	non-name
ⲉⲧⲛϩⲏⲧⲕ	non-name
ⲉⲧⲛⲁⲁⲁⲥ	non-name
ⲉⲧⲛⲁⲁⲥ	non-name
ⲉⲧⲛⲁⲥⲉⲡⲥ	non-name
ⲉⲧⲛⲙⲙⲁⲥ	non-name
ⲉⲧⲣⲉϥϫⲡⲉⲡⲕⲟⲥⲙⲟⲥ	non-name
ⲉⲩϣⲁⲛϫⲟⲟⲥ	non-name
ⲉⲩϩⲁ	non-name
ⲉⲩⲁϣⲕⲁⲕ	non-name
ⲉⲩⲛⲧⲁⲓ	non-name
ⲉⲩⲛⲧⲁⲕ	non-name
ⲉⲩⲛⲧⲁⲛ	non-name
ⲉⲩⲛⲧⲁⲩ	non-name
ⲉⲩⲡⲁⲣⲟⲝⲩⲥⲙⲟⲥ	non-name
ⲉⲩⲡⲣⲟϩⲓⲥⲧⲁ	non-name	
ⲉⲫⲉⲥⲟⲥ	place	M
ⲍⲁⲃⲟⲩⲗⲟⲛ	persona	M
ⲍⲁⲕⲭⲁⲓⲟⲥ	persona	M
ⲍⲁⲗⲉϩ	persona	M
ⲍⲁⲣⲁ	persona	M
ⲍⲁⲭⲁⲣⲓⲁⲥ	persona	M
ⲍⲉⲃⲉⲇⲁⲓⲟⲥ	persona	M
ⲍⲉⲗⲫⲁ	persona	F
ⲍⲏⲛⲁ	persona	M
ⲍⲟⲣⲟⲃⲁⲃⲉⲗ	persona	M
ⲏϩⲉⲛⲁⲡⲓⲥⲧⲟⲥ	non-name
ⲏϩⲛ	non-name
ⲏϫⲉⲕⲁⲁⲥ	non-name
ⲏⲉⲛⲛⲁⲕⲁⲁⲥ	non-name
ⲏⲉⲧⲉⲧⲛⲁϫⲟⲟⲥ	non-name
ⲏⲙⲁⲥ	non-name	
ⲏⲛⲓⲙ	non-name
ⲏⲛⲧⲁ	non-name
ⲏⲛ	non-name
ⲏⲟⲩⲁⲅⲅⲉⲗⲟⲥ	non-name	
ⲏⲟⲩⲕⲓⲛⲇⲩⲛⲟⲥ	non-name
ⲏⲟⲩⲡⲛⲉⲩⲙⲁⲧⲓⲕⲟⲥ	non-name
ⲏⲥⲁⲓⲁⲥ	persona	M
ⲏⲥⲁⲩ	persona	M
ⲑⲁⲗⲗⲁⲥⲥⲁ	non-name
ⲑⲉⲟⲇⲟⲣⲟⲥ	persona	M
ⲑⲉⲩⲧⲁⲥ	persona	M
ⲑⲉⲱⲇⲱⲣⲟⲥ	persona	M
ⲑⲉⲱⲫⲓⲗⲟⲥ	persona	M
ⲑⲱⲙⲁⲥ	persona	M
ⲓⲁⲕⲕⲱⲃⲟⲥ	persona	M
ⲓⲁⲕⲱⲃⲟⲥ	persona	M	# same as ⲓⲁⲕⲕⲱⲃⲟⲥ, ⲓⲁⲕⲱⲃ
ⲓⲁⲕⲱⲃ	persona	M
ⲓⲁⲙⲃⲣⲏⲥ	persona	M
ⲓⲁⲛⲛⲏⲥ	persona	M
ⲓⲁⲥⲥⲱⲛ	persona	M
ⲓⲁⲥⲱⲛ	persona	M	# same as ⲓⲁⲥⲥⲱⲛ
ⲓⲉⲍⲉⲕⲓⲏⲗ	persona	M
ⲓⲉⲣⲉⲙⲓⲁⲥ	persona	M
ⲓⲉⲣⲏⲙⲓⲁⲥ	persona	M	#same as ⲓⲉⲣⲉⲙⲓⲁⲥ
ⲓⲉⲥⲥⲁⲓ	persona	M
ⲓⲉⲭⲟⲛⲓⲁⲥ	persona	M
ⲓⲏⲥⲟⲩⲥ	persona	M	# same as ⲓⲥ
ⲓⲙⲏⲧⲓ	non-name
ⲓⲟⲣⲇⲁⲛⲏⲥ	persona	M
ⲓⲟⲩⲇⲁⲓⲁ	place	F
ⲓⲟⲩⲇⲁⲓ	non-name
ⲓⲟⲩⲇⲁⲥ	persona	M
ⲓⲟⲩⲇⲁ	persona	M
ⲓⲟⲩⲗⲓⲁ	persona	F
ⲓⲟⲩⲗⲓⲟⲥ	persona	M
ⲓⲟⲩⲛⲓⲁ	persona	F
ⲓⲟⲩⲥⲧⲟⲥ	persona	M
ⲓⲥϩⲏⲏⲧⲉ	non-name
ⲓⲥⲁⲁⲕ	persona	M
ⲓⲥⲕⲁⲣⲓⲱⲧⲏⲥ	non-name
ⲓⲥⲙⲁⲏⲗ	persona	M
ⲓⲥⲣⲁⲏⲗ	place	M	# same as ⲉⲓⲥⲣⲁⲏⲗ
ⲓⲧⲉⲗⲱⲛⲏⲥ	non-name
ⲓⲱϩⲁⲛⲏⲥ	persona	M
ⲓⲱϩⲁⲛⲛⲁ	persona	F
ⲓⲱϩⲁⲛⲛⲏⲥ	persona	M	# same as ⲓⲱϩⲁⲛⲏⲥ and ⲓⲱⲁⲛⲛⲏⲥ
ⲓⲱⲁⲛⲛⲏⲥ	persona	M
ⲓⲱⲃⲏⲇ	persona	M
ⲓⲱⲏⲗ	persona	M
ⲓⲱⲣⲁⲙ	persona	M
ⲓⲱⲥⲁⲫⲁⲧ	persona	M
ⲓⲱⲥⲏⲥ	persona	M	# same as ⲓⲱⲥⲏ
ⲓⲱⲥⲏⲫ	persona	M
ⲓⲱⲥⲏ	persona	M
ⲓⲱⲥⲓⲁⲥ	persona	M
ⲕⲁⲓⲛ	persona	M
ⲕⲁⲓⲟⲥ	persona	M
ⲕⲁⲓⲥⲁⲣⲓⲁ	place	F	#  same as ⲕⲁⲓⲥⲁⲣⲓⲁ
ⲕⲁⲓⲫⲁⲥ	persona	M
ⲕⲁⲡⲁⲣⲛⲁⲟⲩⲙ	place	M
ⲕⲁⲥⲓⲁⲛⲟⲥ	persona	M
ⲕⲁⲧⲁϣⲁ non-name
ⲕⲁⲫⲁⲣⲛⲁⲟⲩⲙ	place	M	# same as ⲕⲁⲡⲁⲣⲛⲁⲟⲩⲙ
ⲕⲉⲥⲁⲣⲓⲁ	place	F
ⲕⲏⲙⲉ	place	F
ⲕⲏⲫⲁⲥ	persona	M
ⲕⲗⲁⲩⲇⲓⲟⲥ	persona	M
ⲕⲟⲣⲛⲏⲗⲓⲟⲥ	persona	M
ⲕⲟⲩⲁⲣⲧⲟⲥ	persona	M
ⲕⲣⲓⲥⲡⲟⲥ	persona	M
ⲕⲣⲟⲛⲟⲥ	persona	M
ⲗⲁⲍⲁⲣⲟⲥ	persona	M
ⲗⲁⲟⲇⲓⲕⲓⲁ	place	F
ⲗⲉⲅⲉⲱⲛ	persona	M
ⲗⲉⲅⲓⲱⲛ	persona	M	# same as ⲗⲉⲅⲓⲱⲛ
ⲗⲓⲁ	persona	F
ⲗⲓⲃⲁⲛⲟⲥ	persona	M
ⲗⲟⲩⲕⲁⲥ	persona	M
ⲗⲟⲩⲕⲓⲟⲥ	persona	M
ⲗⲩⲥⲓⲁⲥ	persona	M
ⲗⲱⲧ	persona	M
ⲙⲁⲅⲇⲁⲗⲏⲛⲏ	non-name
ⲙⲁⲑⲓⲁⲥ	persona	M
ⲙⲁⲙⲙⲱⲛⲁⲥ	persona	M	# same as ⲁⲙⲙⲱⲛⲁⲥ and ⲙⲁⲙⲱⲛⲁⲥ
ⲙⲁⲛⲁⲥⲥⲏ	persona	M
ⲙⲁⲣⲁⲛⲁⲑⲁ	non-name
ⲙⲁⲣⲑⲁ	persona	F
ⲙⲁⲣⲓϩⲁⲙ	persona	F
ⲙⲁⲣⲓⲁ	persona	F	# same as ⲙⲁⲣⲓϩⲁⲙ
ⲙⲁⲣⲕⲟⲥ	persona	M
ⲙⲁⲧⲑⲁⲙ	persona	M
ⲙⲉⲗⲭⲓⲥⲉⲇⲉⲕ	persona	M
ⲙⲉⲣⲉⲡⲟⲩⲁ	non-name
ⲙⲉⲥⲥⲓⲁⲥ	persona	M
ⲙⲓⲭⲁⲏⲗ	persona	M
ⲙⲙⲁⲑⲑⲁⲑⲓⲁⲥ	persona	M
ⲙ ⲙⲁⲑⲟⲩⲥⲁⲗⲁ	persona	M
ⲙ ⲙⲁⲗⲉⲏⲗ	persona	M
ⲙ ⲙⲁⲧⲧⲁⲑⲁ	persona	M
ⲙ ⲙⲁⲧⲧⲁⲑⲓⲁⲥ	persona	M
ⲙ ⲙⲉⲛⲛⲁ	persona	M
ⲙⲙⲛⲗⲁⲁⲩ	non-name
ⲙⲟⲥ	non-name
ⲙⲡϩⲉⲕⲁⲧⲟⲛⲧⲁⲣⲭⲟⲥ	non-name
ⲙⲡⲁ	non-name
ⲙⲡⲉϣⲗⲏⲗ	non-name
ⲉⲓⲥⲣⲁⲏⲗ	place	M
ⲙⲡⲉⲡⲛⲟⲙⲟⲥ	non-name
ⲙⲡⲕⲧⲉϩⲥ	non-name
ⲙⲡⲣϥⲓⲣⲟⲟⲩϣ	non-name
ⲙⲡⲱⲣ	non-name
ⲙⲱⲩⲥⲏⲥ	persona	M
ⲛⲁϣⲃⲣⲁⲓⲭⲙⲁⲗⲱⲧⲟⲥ	non-name
ⲛⲁⲁⲥⲥⲱⲛ	persona	M
ⲛⲁⲉⲓⲧⲟⲥ	non-name
ⲛⲁⲉⲧⲟⲥ	non-name
ⲛⲁⲍⲁⲣⲉⲑ	place	M
ⲛⲁⲍⲁⲣⲏⲛⲟⲥ	non-name
ⲛⲁⲑⲁⲛⲁⲏⲗ	persona	M
ⲛⲁⲕⲉⲣⲁⲓⲟⲥ	non-name
ⲛⲁⲗⲗⲟⲫⲩⲗⲟⲥ	non-name
ⲛⲁⲗⲧⲕⲁⲥ	non-name
ⲁⲗⲫⲁⲓⲟⲥ	persona	M
ⲛⲁⲙⲉⲑⲩⲥⲧⲟⲥ	non-name
ⲛⲁⲣⲕⲓⲥⲥⲟⲥ	persona	M
ⲛ ⲁⲣⲭⲓⲡⲡⲟⲥ	persona	M
ⲛⲁⲣⲭⲓⲥⲩⲛⲁⲅⲱⲅⲟⲥ	non-name
ⲃⲁⲗⲁϩⲁⲙ	persona	M
ⲛⲉϣⲗⲏⲗ	non-name
ⲛⲉϥⲕⲉⲇⲓⲁⲕⲟⲛⲟⲥ	non-name
ⲛⲉϩⲙⲟⲟⲥ	non-name
ⲛⲉⲁⲡⲟⲗⲓⲥ	place	F
ⲛⲉⲉⲓⲧⲟⲗⲙⲁ	non-name
ⲛⲉⲕⲕⲁⲧⲏⲅⲟⲣⲟⲥ	non-name
ⲛⲉⲕⲣⲏⲧⲏⲥ	non-name
ⲛⲉⲛⲧⲁ	non-name
ⲛ ⲉⲛⲱⲥ	persona	M
ⲛ ⲉⲡⲁⲫⲣⲁ	persona	M
ⲛ ⲉⲡⲁⲫⲣⲟⲇⲓⲧⲟⲥ	persona	M
ⲛⲉⲡⲣⲉⲥⲃⲉⲧⲉⲣⲟⲥ	non-name
ⲛⲉⲣⲉⲛϣⲟⲟⲥ	non-name
ⲛⲉⲣⲉⲛⲇⲁⲓⲙⲱⲛⲓⲟⲛ	non-name
ⲛⲉⲣⲉⲛⲧⲉⲗⲱⲛⲏⲥ	non-name
ⲛⲉⲣⲉⲡⲗⲁⲟⲥ	non-name
ⲛⲉⲣⲉⲡⲟⲩⲁ	non-name
ⲛⲉⲣⲉⲡⲡⲁⲥⲭⲁ	non-name
ⲛⲉⲥⲕⲉⲕⲗⲁⲇⲟⲥ	non-name
ⲛⲉⲥⲧⲟⲓⲕⲟⲥ	non-name
ⲛⲉⲧϩⲁ	non-name
ⲛⲉⲧϩⲓϫⲙ	non-name
ⲛⲉⲧϩⲛ	non-name
ⲛⲉⲧⲁϩⲉⲣⲁⲧⲟⲩ	non-name
ⲛⲉⲧⲉⲟⲩⲛⲧⲁⲩ	non-name
ⲛⲉⲧⲉⲧⲛⲁⲕⲁ	non-name
ⲛⲉⲧⲛϣⲗⲏⲗ	non-name
ⲛⲉⲩϯⲁⲁⲥ	non-name
ⲛⲉⲩⲛⲁⲣⲁⲧⲓⲟⲩ	non-name
ⲛⲉⲩⲛⲧⲁⲩ	non-name
ⲛⲉⲫⲁⲣⲣⲓⲥⲁⲓⲟⲥ	non-name
ⲛⲉⲫⲑⲁⲗⲉⲓⲙ	persona	M
ⲛ ⲍⲁⲃⲟⲩⲗⲱⲛ	persona	M
ⲛⲏⲣⲉⲁⲥ	persona	M
ⲛ ⲑⲁⲣⲣⲁ	persona	M
ⲛⲓⲧⲉⲗⲓⲟⲥ	non-name
ⲛ ⲓⲱⲛⲁⲥ	persona	M
ⲛ ⲕⲁⲓⲛⲁⲙ	persona	M
ⲛⲕⲁⲧⲁⲡⲉⲧⲁⲥⲙⲁ	non-name
ⲛⲕⲁⲧⲁ	non-name
ⲛⲕⲁⲧⲏⲅⲟⲣⲟⲥ	non-name
ⲛⲕⲟⲓⲛⲱⲛⲓⲕⲟⲥ	non-name
ⲛⲕⲟⲣⲟⲥ	non-name
ⲛⲕⲩⲡⲣⲓⲟⲥ	non-name
ⲛⲗⲓⲃⲉⲣⲧⲓⲛⲟⲥ	non-name
ⲛⲙ ⲗⲩⲥⲁⲛⲓⲁⲥ	persona	M
ⲛⲙ ⲙⲁⲑⲑⲁⲓⲟⲥ	persona	M
ⲛⲙⲙⲡⲟⲣⲛⲟⲥ	non-name
ⲛⲙⲛϩⲏⲣⲱⲇⲓⲁⲛⲟⲥ	non-name
ⲛⲙⲛⲁ	non-name
ⲛⲙⲛⲛⲟⲙⲓⲕⲟⲥ	non-name
ⲛⲙⲟⲩⲧⲉⲗⲏⲗ	non-name
ⲛⲙⲡⲁⲅⲅⲉⲗⲟⲥ	non-name
ⲛⲙ ⲡ ⲁⲙⲙⲱⲛⲁⲥ	persona	M
ⲛⲙⲡⲟⲣⲛⲟⲥ	non-name
ⲛⲙⲡⲟⲣⲟⲥ	non-name
ⲛⲛⲅⲉⲣⲁⲥⲏⲛⲟⲥ	non-name
ⲛⲛⲉⲁⲅⲅⲉⲗⲟⲥ	non-name
ⲛⲛⲉⲛⲧⲁ	non-name
ⲛⲛⲉⲧϩⲁ	non-name
ⲛⲛⲓⲕⲟⲗⲁⲓⲧⲏⲥ	non-name
ⲛⲛⲥⲁⲇⲇⲟⲩⲕⲁⲓⲟⲥ	non-name
ⲛ ⲟⲛⲏⲥⲓⲫⲟⲣⲟⲥ	persona	M
ⲛⲟⲩϩⲁⲙ	non-name
ⲛⲟⲩⲙⲁⲥ	non-name
ⲛⲟⲯⲱⲛⲓⲟⲛ	non-name
ⲛⲣⲓ	non-name
ⲛⲥⲁⲇⲇⲟⲩⲕⲁⲓⲟⲥ	non-name
ⲛ ⲥⲁⲗⲁ	persona	M
ⲛⲥⲉϫⲟⲟⲥ	non-name
ⲛⲥⲉⲁⲁⲥ	non-name
ⲛⲥⲉⲙⲛⲟⲥ	non-name
ⲛⲥⲉⲡⲗⲁⲛⲁ	non-name
ⲛⲥⲉⲧϭⲁⲓⲟⲥ	non-name
ⲛⲥⲉⲧⲁⲁⲥ	non-name
ⲛⲥⲉⲧⲙϫⲟⲟⲥ	non-name
ⲛⲥⲉⲧⲙⲕⲁ	non-name
ⲛⲥⲟⲩⲁ	non-name
ⲛⲥⲡⲟⲩⲇⲁⲓⲟⲥ	non-name
ⲛⲥⲩⲙⲙⲉⲧⲟⲭⲟⲥ	non-name
ⲛⲧⲁϣⲗⲏⲗ	non-name
ⲛⲧⲁⲙⲛⲧⲁⲡⲟⲥⲧⲟⲗⲟⲥ	non-name
ⲛⲧⲁⲣⲉϥϫⲁⲥ	non-name
ⲛⲧⲁⲩⲟⲡⲥ	non-name
ⲛⲧⲁⲩⲥⲛⲧ	non-name
ⲛⲧⲉⲉⲓϩⲉ	non-name
ⲛⲧⲉⲓⲡⲣⲟⲫⲏⲧⲉⲓⲁ	non-name
ⲛⲧⲉⲗⲏⲗ	non-name
ⲛⲧⲉⲗⲓⲟⲥ	non-name
ⲛⲧⲉⲛϯⲗⲏⲗ	non-name
ⲛⲧⲉⲣⲉⲛⲁⲅⲅⲉⲗⲟⲥ	non-name
ⲛⲧⲉⲣⲉⲡⲉⲫⲁⲣⲓⲥⲥⲁⲓⲟⲥ non-name
ⲛⲧⲉⲣⲉⲣⲟⲩϩⲉ	non-name
ⲛⲧⲉⲣⲉⲩϩⲙϩⲁⲗ	non-name
ⲛⲧⲉⲣⲟⲩⲣⲱⲧ	non-name
ⲛ ⲧⲓⲃⲉⲣⲓⲟⲥ	persona	M
ⲛⲧⲙⲛⲧⲁⲡⲟⲥⲧⲟⲗⲟⲥ	non-name
ⲛⲧⲛⲧⲟⲗⲙⲁ	non-name
ⲛⲧⲡⲉⲣⲓⲭⲱⲣⲟⲥ	non-name
ⲛ ⲭⲟⲩⲍⲁ	persona	M
ⲛⲱϩⲉ	non-name
ⲟⲇⲟⲗⲗⲁ	persona	F
ⲟⲍⲉⲓⲁⲥ	persona	M
ⲟⲙⲡⲟⲛⲏⲣⲟⲥ	non-name
ⲟⲛⲏⲥⲓⲙⲟⲥ	persona	M
ⲟⲛ	non-name
ⲟⲩϣⲗⲏⲗ	non-name
ⲟⲩϩⲉⲕⲁⲧⲟⲛⲧⲁⲣⲭⲟⲥ	non-name
ⲟⲩϩⲉⲣⲁⲓⲧⲓⲕⲟⲥ	non-name
ⲟⲩϩⲏⲅⲟⲩⲙⲉⲛⲟⲥ	non-name
ⲟⲩϩⲟⲩⲉⲡⲣⲟⲫⲏⲧⲏⲥ	non-name
ⲟⲩⲕⲟⲗⲡⲟⲥ	non-name
ⲟⲩⲗⲉⲩⲉⲓⲧⲏⲥ	non-name
ⲟⲩⲙⲛⲧϣⲛⲁ	non-name
ⲟⲩⲛϩⲉⲛϩⲉⲃⲱⲱⲛ	non-name
ⲟⲩⲛϩⲉⲛϩⲟⲟⲩ	non-name
ⲟⲩⲛⲟⲙⲟⲇⲓⲇⲁⲥⲕⲁⲗⲟⲥ	non-name
ⲟⲩⲛⲟⲩϩⲉⲑⲛⲟⲥ	non-name
ⲟⲩⲛⲟⲩⲕⲁⲩⲥⲱⲛ	non-name
ⲟⲩⲛⲧⲏⲧⲛ	non-name
ⲟⲩⲡⲣⲟⲥⲏⲗⲩⲧⲟⲥ	non-name
ⲟⲩⲣⲉϥϫⲓⲕⲃⲁ	non-name
ⲟⲩⲣⲓⲁⲥ	persona	M
ⲟⲩⲥⲁⲃⲃⲁⲧⲓⲥⲙⲟⲥ	non-name
ⲟⲩⲥⲡⲟⲅⲅⲟⲥ	non-name
ⲟⲩⲧⲉⲗⲏⲗ	non-name
ⲟⲩⲭ	non-name
ⲡϣⲁⲁ	non-name
ⲡϣⲁ	non-name
ⲡϣⲓⲕⲉ	non-name
ⲡϣⲙϣⲉ	non-name
ⲡϣⲟⲩⲁ	non-name
ⲡϣⲣⲡ	non-name
ⲡϩⲁⲙⲏⲛ	non-name
ⲡϩⲉⲃⲱⲛ	non-name
ⲡϩⲉⲕⲁⲧⲟⲛⲧⲁⲣⲭⲟⲥ	non-name
ⲡϩⲙⲥ	non-name
ⲡϩⲣϣⲓⲣⲉ	non-name
ⲡ ϩⲣⲙⲏⲥ	persona	M
ⲡϩⲱⲛ	non-name
ⲡϩⲱⲟⲩ	non-name
ⲡϩⲱⲡ	non-name
ⲡϫⲓⲟⲩⲁ	non-name
ⲡϫⲓ	non-name
ⲡϫⲱⲕⲙ	non-name
ⲡϫⲱⲕ	non-name
ⲡϭⲁϩϭϩ	non-name
ⲡϭⲱⲙ	non-name
ⲡⲁⲓⲅⲉⲛⲟⲥ	non-name
ⲡⲁⲙⲃⲱ	persona	M
ⲡ ⲁⲛⲇⲓⲭⲣⲏⲥⲧⲟⲥ	persona	M
ⲡ ⲁⲛⲧⲓⲭⲣⲏⲥⲧⲟⲥ	persona	M	# same as ⲁⲛⲇⲓⲭⲣⲏⲥⲧⲟⲥ and ⲁⲛⲧⲓⲭⲣⲓⲏⲥⲟⲩⲥⲧⲟⲥ
ⲡ ⲁⲛⲧⲓⲭⲣⲓⲏⲥⲟⲩⲥⲧⲟⲥ	persona	M
ⲡ ⲁⲛⲧⲣⲓⲁⲥ	place	M
ⲡⲁⲣⲓⲅⲟⲣⲓ	place	M
ⲡⲁⲣⲙⲉⲛⲁⲥ	persona	M
ⲡⲁⲣⲭⲏⲥⲩⲛⲁⲅⲱⲅⲟⲥ	non-name
ⲡⲁⲣⲭⲓⲅⲟⲥ	non-name
ⲡⲁⲣⲭⲓⲧⲣⲓⲕⲗⲓⲛⲟⲥ	non-name
ⲡⲁⲥⲡⲁⲥⲙⲟⲥ	non-name
ⲡⲁⲥⲧⲁⲙⲱⲛ	persona	M
ⲡⲁⲩⲗⲉ	persona	M
ⲡⲁⲩⲗⲟⲥ	persona	M	# same as ⲡⲁⲩⲗⲉ
ⲡⲃⲁⲥⲓⲗⲓⲕⲟⲥ	non-name
ⲡⲉϣⲁⲩⲕⲁ	non-name
ⲡⲉϣⲗⲏⲗ	non-name
ⲡⲉϩⲙⲟⲟⲥ	non-name
ⲡⲉϫⲉⲕⲉⲩⲁ	non-name
ⲡⲉϫⲉⲛⲁⲡⲟⲥⲧⲟⲗⲟⲥ	non-name
ⲡⲉϫⲉⲟⲩⲁ	non-name
ⲡⲉϫⲉⲡϩⲙϩⲁⲗ	non-name
ⲡⲉϫⲉⲡϫⲟⲉⲓⲥ	non-name
ⲡⲉϫⲉⲡⲁⲅⲅⲉⲗⲟⲥ	non-name
ⲡⲉϫⲉⲡⲕⲉⲟⲩⲁ	non-name
ⲡⲉϫⲉⲡⲕⲉⲩⲁ	non-name
ⲡⲉϫⲉⲡⲟⲓⲕⲟⲛⲟⲙⲟⲥ	non-name
ⲡⲉⲓⲡⲗⲁⲛⲟⲥ	non-name
ⲡⲉⲓⲧⲓⲧⲗⲟⲥ	non-name
ⲡⲉⲛⲥⲟⲡⲥ	non-name
ⲡⲉⲛⲧϥⲣⲁⲥ	non-name
ⲡⲉⲛⲧⲁ	non-name
ⲡⲉⲣⲥⲓⲥ	persona	F
ⲡⲉⲥⲧⲣⲁⲧⲏⲕⲟⲥ	non-name
ⲡⲉⲧϩⲓϫⲙ	non-name
ⲡⲉⲧϩⲛ	non-name
ⲡⲉⲧⲉϩⲛⲁⲥ	non-name
ⲡⲉⲧⲉⲛⲉϥϣⲟⲟⲡ	non-name
ⲡⲉⲧⲉ	non-name
ⲡⲉⲧⲙⲡⲉⲧⲛⲁⲁⲥ	non-name
ⲡⲉⲧⲛϣⲗⲏⲗ	non-name
ⲡⲉⲧⲛⲁϫⲟⲟⲥ	non-name
ⲡⲉⲧⲛⲁⲁⲡⲁⲣⲛⲁ	non-name
ⲡⲉⲧⲛⲁⲛⲧⲓⲇⲓⲕⲟⲥ	non-name
ⲡⲉⲧⲛⲁⲥⲟⲣⲙⲉⲥ	non-name
ⲡⲉⲧⲛⲧⲁⲥ	non-name
ⲡⲉⲧⲣⲁ	non-name	
ⲡⲉⲧⲣⲟⲥ	persona	M
ⲡⲓⲗⲁⲧⲟⲥ	persona	M
ⲡⲕⲉⲥⲉⲡⲏ	non-name	
ⲡⲗⲁⲛⲟⲥ	non-name
ⲡ ⲙⲁⲙⲱⲛⲁⲥ	persona	M
ⲡⲙⲉϩϣⲟⲙⲛⲧ non-name
ⲡⲙⲉϩⲥⲛⲁⲩ	non-name
ⲡⲛⲁⲍⲁⲣⲏⲛⲟⲥ	non-name
ⲡⲟⲛⲧⲓⲟⲥ	persona	M
ⲡⲟⲣⲕⲓⲟⲥ	persona	M
ⲡⲡⲁⲛⲧⲱⲕⲣⲁⲧⲱⲣ	non-name
ⲁⲡⲡⲓⲟⲥ	persona	M
ⲡ ⲡⲟⲛⲧⲟⲥ	place	M
ⲡⲣⲟⲥⲟⲩⲟⲉⲓϣ	non-name
ⲡⲥⲟⲓ	non-name
ⲡⲥⲟⲡⲥ	non-name
ⲡⲧⲉⲧⲣⲁⲣⲭⲏⲥ	non-name
ⲡⲧⲣⲉϥϣⲗⲏⲗ	non-name
ⲡⲭⲓⲗⲓⲁⲣⲭⲟⲥ	non-name
ⲣⲁⲕⲟⲧⲉ	place	F
ⲥⲁⲇⲇⲟⲩⲕⲁⲓⲟⲥ	non-name
ⲥⲁⲇⲱⲕ	persona	M
ⲥⲁⲗⲁⲑⲓⲏⲗ	persona	M
ⲥⲁⲗⲙⲱⲛ	persona	M
ⲥⲁⲙⲟⲩⲏⲗ	persona	M
ⲥⲁⲙⲯⲱⲛ	persona	M
ⲥⲁⲟⲩⲗ	persona	M
ⲥⲁⲣⲁⲡⲓⲟⲛ	persona	M
ⲥⲁⲣⲣⲁ	persona	F
ⲥⲁⲧⲁⲛⲁⲥ	persona	M
ⲥⲁⲩⲗⲟⲥ	persona	M
ⲥⲉⲗⲉⲩⲕⲓⲁ	place	F
ⲥⲉⲡⲥⲡϫⲟⲉⲓⲥ	non-name
ⲥⲓⲗⲁⲥ	persona	M
ⲥⲓⲗⲟⲩⲁⲛⲟⲥ	persona	M
ⲥⲓⲙⲱⲛ	persona	M
ⲥⲓⲛⲁ	place	F
ⲥⲓⲱⲛ	place	F
ⲥⲟⲇⲟⲙⲁ	place	F
ⲥⲟⲗⲟⲙⲱⲛ	persona	M
ⲥⲧⲉⲫⲁⲛⲟⲥ	persona	M
ⲥⲩⲙⲉⲱⲛ	persona	M
ⲥⲩⲛϩⲉⲇⲣⲓⲟⲛ	non-name
ⲥⲩⲣⲓⲁ	place	F
ⲥⲱⲥⲓⲡⲁⲧⲣⲟⲥ	persona	M
ⲧⲁϫⲟⲟⲥ	non-name
ⲧⲁⲃⲓⲑⲁ	persona	F
ⲧⲁⲗⲉⲓⲑⲁ	non-name
ⲧⲁⲛⲓⲙ	non-name
ⲧ ⲁⲛⲧⲓⲟⲭⲓⲁ	place	F
ⲧⲁⲣⲛϣⲗⲏⲗ	non-name
ⲧⲁⲣⲛϫⲟⲟⲥ	non-name
ⲧⲁⲣⲟⲩ	non-name
ⲧⲁⲣⲥⲟⲥ	place	M
ⲧⲉⲗⲓⲟⲥ	non-name
ⲧⲉⲛⲧⲁ	non-name
ⲧⲉⲣⲧⲓⲟⲥ	persona	M
ⲧⲉⲣⲧⲩⲗⲗⲟⲥ	persona	M
ⲧⲉⲥⲡⲉⲓⲣⲁ	non-name
ⲧⲉⲥⲫⲣⲁⲅⲓⲥ	non-name
ⲧⲉⲧⲉⲩⲛⲧⲥ	non-name
ⲧⲓⲃⲉⲣⲓⲁⲥ	persona	M
ⲧⲓⲙⲁⲓⲟⲥ	persona	M
ⲧⲓⲙⲟⲑⲉⲟⲥ	persona	M
ⲧⲓⲧⲟⲥ	persona	M
ⲧⲗⲩⲡⲏ	non-name
ⲧⲙϩⲉ	non-name
ⲧⲙⲛⲁ	non-name
ⲧⲛⲙⲡⲉⲓⲙⲁ	non-name
ⲧⲟⲣⲕⲁⲥ	persona	F
ⲧⲟⲩⲛⲧⲏⲩⲧⲛ	non-name
ⲧⲟⲩⲡⲓⲥⲧⲓⲥ	non-name
ⲧⲡⲉⲣⲓⲭⲱⲣⲟⲥ	non-name
ⲧⲡⲉⲧⲣⲁ	non-name
ⲧⲣⲱⲁⲥ	place	F
ⲧⲥⲩⲛⲓⲇⲏⲥⲓⲥ	non-name
ⲧⲩⲙⲏⲧⲣⲓⲟⲥ	persona	M
ⲧⲩⲣⲟⲥ	place	M
ⲧⲩⲭⲓⲕⲟⲥ	persona	M
ⲧⲱⲟⲩ	non-name
ⲫⲁⲛⲟⲩⲏⲗ	persona	M
ⲫⲁⲣⲁⲱ	persona	M
ⲫⲁⲣⲉⲥ	persona	M
ⲫⲁⲣⲓⲥⲥⲁⲓⲟⲥ	non-name
ⲫⲏⲗⲓⲝ	persona	M
ⲫⲏⲥⲧⲟⲥ	persona	M
ⲫⲓⲗⲁⲅⲣⲓⲟⲥ	persona	M
ⲫⲓⲗⲓⲡⲡⲟⲥ	persona	M
ⲫⲓⲗⲟⲑⲉⲟⲥ	persona	M
ⲫⲓⲗⲟⲑⲉⲥ	persona	M
ⲫⲟⲓⲃⲁⲙⲙⲱⲛ	persona	M
ⲭⲁⲏⲗ	persona	M
ⲭⲁⲛⲁⲁⲛ	place	F
ⲭⲣⲓⲥⲧⲟⲥ	persona	M
ⲭⲣⲓⲥⲧⲟⲫⲟⲣⲟⲥ	persona	M
ⲱⲥⲁⲛⲛⲁ	persona	M